Вконтакте - vk
Одноклассники - ok
Whatsapp  - wa
Viber  - vi
Telegram - tg
QIWI - qw
OLX - sn
Kufar - kb
Google,youtube,Gmail - go
avito - av
facebook - fb
Twitter - tw
Uber - ub
Gett - gt
Instagram  - ig
Юла - ym
Airbnb - uk
Пятерочка - bd
Delivery Club - dt
Яндекс  - ya
Steam - mt
Tinder - oi
Mamba, MeetMe - fd
Магнит - mg
Netflix - nf
Discord - ds
TikTok/Douyin - lf
Amazon  - am
ProtonMail - dp
Citymobil - yf
MEGA - qr
СпортМастер - yk
Snapchat - fu
OZON - sg
Wildberries - uu
BlaBlaCar - ua
AliPay - hw
MTS CashBack - da
Nike - ew
PayPal - ts
Blizzard - bz
YandexGo - wf
МВидео - tk
Adidas - an
WeChat - wb
Любой другой - ot